1111111111111111111
1P00000000000000001
1000CC0000000000001
1000000000111110001
10000C0000000000001
100000000KKK0000001
1000000000000000001
1001111000000000001
100000000000CC00001
1000111100000000001
10K01110000K0000001
10C0100000000111111
100010000CC00000001
10111000K00000K0001
1111111100000011111
1111111111011111111
1000000000000K00001
111111100E001111111
1111111111111111111
