111111111111111111111111
111111111111111111111111
111111111111111111111111
111000000000000000011111
111000001111111111011111
111000001111111111011111
111000001111111111011111
111000000000000000011111
111000000000000000011111
1110000P0000000000011111
11100000000000C000011111
111000000000000000011111
111000000E00000000011111
111000000000000000011111
111000000000000000011111
111000001111110000011111
111000001111110000011111
111000001111110000011111
111000001111110000011111
111111111111111111111111
