111111111111111111
100000000000C00001
10CKE0000000000001
1000000KK000C00001
100C00000000C00001
100000C0000000P001
111111111111111111