1111111111111
1111000001111
10010P0001001
1001000001001
1111000001111
1111100011111
1111100011111
1111100011111
100000C000001
1001000001001
100000E000001
1001000001001
1000000000001
1100011100011
1100011100011
1000001100011
1000001000001
1000001000001
1000001000001
1111111100011
1111111100011
1111111100011
1111100000001
1000100111001
1000100001111
1000100111001
1101100000001
1101111100011
1101111100011
1000001000001
1000000001001
1000001000001
1111111110111
1111111110111
1100011100011
1100000000011
1100011100011
1111111111111
