1111111111111111
100000000000C001
100P000000000001
10000000C0011111
1000000000010001
10000ECC00010001
1111111111111111