111111111111111111111111111111111
1P1000100010001000100010001000001
101010101010101010101010101011101
101010101010101010101010101010001
101010101010101010101010101010111
100010001000100C10001000100010001
111111111111111111111111111111101
1E0000000000000000000000000000001
111111111111111111111111111111111