111111111
100000001
101111101
101111101
10P000001
100C00E01
111111111
