11111111111111111111111111111111
1000000000P000000C000000100CCC01
10000000000000011110000010000001
11111001111110000010000011111001
1000000000C010000011000000000001
100011111000100C0001000001111111
10C010000000000000000000E1111111
11111111111111111111111111111111
