11111111111111111111
11111111111111111111
1C0000E00000000000C1
10111111110111111101
1K0K000010000001K0K1
10111110111011111011
10000000010000001001
101111K0111011111011
10000000000000000001
10111101111011111011
1K000000K000000000K1
10111011111101111101
10000000000000001001
101111K0111011111011
1K0000000000000000K1
10111101111101111011
1000000100000P001001
101111K0111011111011
1C000000000K000000C1
11111111111111111111