111111111111111111
10P000000E00000C01
111111111111111111
