111111111111111111
10P000000C00000E01
111111111111111111
