111111111111111111111111111
10000C00000000P00000000C001
1000000000010000000C0000001
10000C000001000000000000011
1000000000010000111111000C1
10010011111100C000000E00001
1CCC00000C0000001110000CCC1
111111111111111111111111111