111111111111111111111111111111111111
111111111111111111111111111111111111
100000000000000000000000000000P00001
101111111111111111111111111111111101
101111111111111111111111111111111101
10000000000000000000000000000000C001
101111111111111111111111111111111101
101111111111111111111111111111111101
100000000000000000000000000000000001
101111111111111111111111111111111101
101111111111111111111111111111111101
10000000000000000000000000000000E001
111111111111111111111111111111111111
