11111111
1P000001
1C1110C1
10100C11
1C1111C1
10000001
11111101
1E000001
11111111
