11111111111111
1P000000C00001
10111111011101
1K000010000K01
10111011101101
10000100001001
10101111101001
1K000000000K01
10111101111001
10000100001001
10111101011101
1K000000000K01
10111110011101
1C0000000000E1
11111111111111