11111111
10000C01
10001001
10P00E01
11111111
