11111111111
111110P00C1
11111000111
111110000E1
11111111111
