11111111111111111
100000000000P0001
10000000000000001
1000000C000000001
10000000000E00001
10000000000000001
11111111111111110