11111111111111111
10000000P00000001
1000000000000CC01
1000000000E000000
11111111111111111
