1111111111
1000C00E01
10P000c001
1111111111
