1111111111
1000000E01
10P0100011
1111111111