1111111111
1000C00C01
10P0000001
1111111111